5 10
0000000XX0
0X00XX0000
00XXX00000
0X0000XXX0
00000000XR