5 10
0000000XX0
XX00XXX000
00XXX00000
0X0000XXX0
00000000XR